|   |   |   |   |   |   |   |   |   |   |   |   |   |   |   |   |   |   |   |   |   |   |   |   |   |   |   |   |   |   |   |   |   |   |   |   |   |   |   |   |   |   |   |   |   |   |   |   |   |   |
|   |   | # |   | # | # |   | # | # | # | # | # | # |   | # | # |   | # | # |   | # |   | # |   |   |   | # |   | # |   |   |   |   |   |   |   |   |   |   |   |   |   |   |   |   |   |   |   |   |   |
|   |   | # | # | # |   |   | # | # |   |   |   |   |   |   |   |   |   | # |   |   |   |   |   |   |   | # |   | # | # | # | # | # | # | # | # | # |   | # | # | # | # | # | # | # | # | # | # | # |   |
|   |   | # |   |   | # | # |   |   |   |   | # |   | # | # | # | # | # | # |   | # |   | # |   | # |   | # |   | # |   |   |   | # |   |   |   | # |   | # |   |   |   |   |   |   |   |   |   |   |   |
|   |   | # |   |   | # |   |   | # | # | # | # |   | # |   |   |   |   |   |   |   |   |   |   |   |   | # | # | # |   | # |   | # |   | # |   | # |   | # |   | # | # | # | # | # | # | # | # | # | # |
|   | # | # |   | # |   |   |   |   | # | # | # |   | # |   |   |   |   | # | # | # | # | # | # | # |   |   |   |   |   | # |   |   |   | # |   | # |   | # |   | # |   |   |   |   |   |   |   |   |   |
|   |   |   |   | # |   | # | # | # |   |   |   |   | # |   |   |   |   | # |   |   |   |   |   | # | # | # | # | # | # | # | # | # |   | # |   | # |   | # |   | # |   |   |   |   |   |   |   |   |   |
|   |   |   |   |   |   | # | * | # | # | # | # | # | # |   |   |   |   | # |   |   |   |   |   |   |   |   |   |   |   |   |   | # |   | # |   | # |   | # |   | # |   |   |   |   |   |   |   |   |   |
| # | # | # | # | # | # | # |   | # |   |   |   |   |   |   |   |   |   | # |   |   |   |   |   |   |   |   |   |   |   |   |   | # |   | # |   | # |   | # |   | # |   |   |   |   |   |   |   |   |   |
|   |   |   |   |   |   |   |   | # |   | # | # | # | # | # | # | # | # | # |   |   |   |   |   |   |   |   |   |   |   |   |   | # |   | # |   | # |   | # |   | # |   |   |   |   |   |   |   |   |   |
|   |   |   |   |   |   |   |   |   |   | # |   |   |   |   |   |   |   |   |   |   |   |   |   |   |   |   |   |   |   |   |   | # |   | # |   |   |   | # |   |   |   |   |   |   |   |   |   |   |   |
|   | # | # |   | # | # |   | # | # |   | # |   |   |   |   |   |   |   |   |   |   |   |   |   |   |   |   |   |   |   |   |   | # |   | # |   | # |   | # |   | # | # |   |   |   |   |   |   |   |   |
| # |   | # | # | # |   |   |   |   |   | # |   |   |   |   |   |   |   |   |   |   |   |   |   |   |   |   |   |   |   | # | # | # |   | # |   | # |   | # |   | # |   |   |   |   |   |   |   |   |   |
| # |   | # |   |   | # | # | # | # |   | # |   |   |   |   |   |   |   |   |   |   |   |   |   |   |   |   |   |   |   | # |   |   |   | # |   | # |   | # |   | # |   |   |   |   |   |   |   |   |   |
| # |   |   |   |   | # |   |   |   |   | # |   |   |   |   |   |   |   |   |   |   |   |   |   |   |   |   |   |   |   | # |   | # | # | # |   | # |   | # | # | # |   |   |   |   |   |   |   |   |   |
| # |   | # | # | # |   |   |   |   |   | # |   |   |   |   |   |   |   |   |   |   |   |   |   |   |   |   |   |   |   | # |   | # |   |   |   |   |   |   |   | # |   |   |   |   |   |   |   |   |   |
|   |   |   |   | # | # | # | # | # |   | # |   |   |   |   |   |   |   |   |   |   |   |   |   |   |   |   |   |   |   | # |   | # |   | # | # | # | # | # |   | # |   |   |   |   |   |   |   |   |   |
|   |   |   |   | # |   |   |   |   |   | # |   |   |   |   |   |   |   |   |   |   |   |   |   |   |   |   |   |   |   | # |   | # |   |   |   |   |   |   |   | # |   |   |   |   |   |   |   |   |   |
|   |   |   |   |   |   |   |   |   |   | # |   |   |   |   |   |   |   |   |   |   |   |   |   |   |   |   |   |   |   | # |   | # | # | # | # | # | # | # |   | # |   |   |   |   |   |   |   |   |   |
| # | # | # | # | # | # | # | # | # | # | # |   |   |   |   |   |   |   |   |   |   |   |   |   |   |   |   |   |   |   | # |   |   |   |   |   |   |   |   |   | # |   |   |   |   |   |   |   |   |   |
|   |   |   |   |   |   |   |   |   |   |   |   |   |   |   |   |   |   |   |   |   |   |   |   |   |   |   |   |   |   | # | # | # | # | # | # | # | # | # | # | # |   |   |   |   |   |   |   |   |   |
|   |   |   |   |   |   |   |   |   |   |   |   |   |   |   |   |   |   |   |   |   |   |   |   |   |   |   |   |   |   |   |   |   |   |   |   |   |   |   |   |   |   |   |   |   |   |   |   |   |   |
|   |   |   |   |   |   |   |   |   |   |   |   |   |   |   |   |   |   |   |   |   |   |   |   |   |   |   |   |   |   |   |   |   |   |   |   |   |   |   |   |   |   |   |   |   |   |   |   |   |   |
|   |   |   |   |   |   |   |   |   |   |   |   |   |   |   |   |   |   |   |   |   |   |   |   |   |   |   |   |   |   |   |   |   |   |   |   |   |   |   |   |   |   |   |   |   |   |   |   |   |   |
|   |   |   |   |   |   |   |   |   |   |   |   |   |   |   |   |   |   |   |   |   |   |   |   |   |   |   |   |   |   |   |   |   |   |   |   |   |   |   |   |   |   |   |   |   |   |   |   |   |   |
|   |   |   |   |   |   |   |   |   |   |   |   |   |   |   |   |   |   |   |   |   |   |   |   |   |   |   |   |   |   |   |   |   |   |   |   |   |   |   |   |   |   |   |   |   |   |   |   |   |   |
|   |   |   |   |   |   |   |   |   |   |   |   |   |   |   |   |   |   |   |   |   |   |   |   |   |   |   |   |   |   |   |   |   |   |   |   |   |   |   |   |   |   |   |   |   |   |   |   |   |   |
|   |   |   |   |   |   |   |   |   |   |   |   |   |   |   |   |   |   |   |   |   |   |   |   |   |   |   |   |   |   |   |   |   |   |   |   |   |   |   |   |   |   |   |   |   |   |   |   |   |   |
|   |   |   |   |   |   |   |   |   |   |   |   |   |   |   |   |   |   |   |   |   |   |   |   |   |   |   |   |   |   |   |   |   |   |   |   |   |   |   |   |   |   |   |   |   |   |   |   |   |   |
|   |   |   |   |   |   |   |   |   |   |   |   |   |   |   |   |   |   |   |   |   |   |   |   |   |   |   |   |   |   |   |   |   |   |   |   |   |   |   |   |   |   |   |   |   |   |   |   |   |   |
|   |   |   |   |   |   |   |   |   |   |   |   |   |   |   |   |   |   |   |   |   |   |   |   |   |   |   |   |   |   |   |   |   |   |   |   |   |   |   |   |   |   |   |   |   |   |   |   |   |   |
|   |   |   |   |   |   |   |   |   |   |   |   |   |   |   |   |   |   |   |   |   |   |   |   |   |   |   |   |   |   |   |   |   |   |   |   |   |   |   |   |   |   |   |   |   |   |   |   |   |   |
|   |   |   |   |   |   |   |   |   |   |   |   |   |   |   |   |   |   |   |   |   |   |   |   |   |   |   |   |   |   |   |   |   |   |   |   |   |   |   |   |   |   |   |   |   |   |   |   |   |   |
|   |   |   |   |   |   |   |   |   |   |   |   |   |   |   |   |   |   |   |   |   |   |   |   |   |   |   |   |   |   |   |   |   |   |   |   |   |   |   |   |   |   |   |   |   |   |   |   |   |   |
|   |   |   |   |   |   |   |   |   |   |   |   |   |   |   |   |   |   |   |   |   |   |   |   |   |   |   |   |   |   |   |   |   |   |   |   |   |   |   |   |   |   |   |   |   |   |   |   |   |   |
|   |   |   |   |   |   |   |   |   |   |   |   |   |   |   |   |   |   |   |   |   |   |   |   |   |   |   |   |   |   |   |   |   |   |   |   |   |   |   |   |   |   |   |   |   |   |   |   |   |   |
|   |   |   |   |   |   |   |   |   |   |   |   |   |   |   |   |   |   |   |   |   |   |   |   |   |   |   |   |   |   |   |   |   |   |   |   |   |   |   |   |   |   |   |   |   |   |   |   |   |   |
|   |   |   |   |   |   |   |   |   |   |   |   |   |   |   |   |   |   |   |   |   |   |   |   |   |   |   |   |   |   |   |   |   |   |   |   |   |   |   |   |   |   |   |   |   |   |   |   |   |   |
|   |   |   |   |   |   |   |   |   |   |   |   |   |   |   |   |   |   |   |   |   |   |   |   |   |   |   |   |   |   |   |   |   |   |   |   |   |   |   |   |   |   |   |   |   |   |   |   |   |   |
|   |   |   |   |   |   |   |   |   |   |   |   |   |   |   |   |   |   |   |   |   |   |   |   |   |   |   |   |   |   |   |   |   |   |   |   |   |   |   |   |   |   |   |   |   |   |   |   |   |   |
|   |   |   |   |   |   |   |   |   |   |   |   |   |   |   |   |   |   |   |   |   |   |   |   |   |   |   |   |   |   |   |   |   |   |   |   |   |   |   |   |   |   |   |   |   |   |   |   |   |   |
|   |   |   |   |   |   |   |   |   |   |   |   |   |   |   |   |   |   |   |   |   |   |   |   |   |   |   |   |   |   |   |   |   |   |   |   |   |   |   |   |   |   |   |   |   |   |   |   |   |   |
|   |   |   |   |   |   |   |   |   |   |   |   |   |   |   |   |   |   |   |   |   |   |   |   |   |   |   |   |   |   |   | # | # | # | # | # |   |   |   |   |   |   |   |   |   |   |   |   |   |   |
|   |   |   |   |   |   |   |   |   |   | # |   |   |   |   |   |   |   |   |   |   |   |   |   |   |   |   |   |   |   |   | # |   |   |   | # |   |   |   |   |   |   |   |   |   |   |   |   |   |   |
|   |   |   |   |   |   |   |   |   |   | # |   |   |   |   |   |   |   |   |   |   |   |   |   |   |   |   |   |   |   |   | # |   |   |   | # |   |   |   |   |   |   |   |   |   |   |   |   |   |   |
|   |   |   |   |   |   |   |   |   |   | # |   |   |   |   |   |   |   |   |   |   |   |   |   |   |   |   |   |   |   |   | # |   | O |   | # |   |   |   |   |   |   |   |   |   |   |   |   |   |   |
|   |   |   |   |   |   |   |   |   |   | # |   |   |   |   |   |   |   |   |   |   |   |   |   |   |   |   |   |   |   |   | # |   |   |   | # |   |   |   |   |   |   |   |   |   |   |   |   |   |   |
|   |   |   |   |   |   |   |   |   |   | # |   |   |   |   |   |   |   |   |   |   |   |   |   |   |   |   |   |   |   |   | # |   |   |   |   |   |   |   |   |   |   |   |   |   |   |   |   |   |   |
|   |   |   |   |   |   |   |   |   |   | # |   |   |   |   |   |   |   |   |   |   |   |   |   |   |   |   |   |   |   |   | # |   |   |   |   |   |   |   |   |   |   |   |   |   |   |   |   |   |   |
|   |   |   |   |   |   |   |   |   |   | # |   |   |   |   |   |   |   |   |   |   |   |   |   |   |   |   |   |   |   |   | # |   |   |   |   |   |   |   |   |   |   |   |   |   |   |   |   |   |   |
