| * |   |   |   |   |   |   |   |   |   |   |   |   |   |   |   |   |   |   |   |
|   | # | # | # | # | # |   | # | # | # | # | # | # |   | # | # |   | # | # |   |
|   | # |   |   |   | # |   | # |   |   |   |   |   |   |   |   |   |   | # |   |
|   | # |   | # |   |   |   | # |   | # | # | # |   | # | # | # | # | # | # |   |
|   | # |   | # | # | # | # | # |   | # | # | # |   | # |   |   |   |   |   |   |
|   | # |   | # | # |   |   |   |   |   | # | # |   | # | # | # |   | # | # |   |
|   | # |   | # | # |   | # | # | # |   |   |   |   |   |   | # |   |   | # |   |
|   |   |   |   |   |   | # |   | # | # | # | # | # | # | # | # |   | # | # |   |
| # | # | # | # | # | # | # |   | # |   |   |   |   |   |   |   |   |   |   |   |
|   |   |   |   |   |   |   |   | # |   | # | # | # | # | # | # | # | # | # |   |
|   | # | # |   | # | # |   |   |   |   | # |   |   |   |   |   |   |   |   |   |
|   | # | # |   | # | # |   | # | # |   | # |   | # |   | # |   | # |   | # |   |
|   | # | # |   |   |   |   | # |   |   | # |   | # |   | # |   | # |   | # |   |
|   | # | # | # | # | # | # | # |   | # | # |   | # |   | # |   | # |   | # |   |
|   | # |   | # | O | # |   |   |   |   | # |   |   |   |   |   |   |   |   |   |
|   | # |   | # |   | # |   | # | # |   | # |   | # |   | # |   | # |   | # |   |
|   | # |   | # |   | # | # | # | # | # | # |   | # |   | # |   | # |   | # |   |
|   | # |   | # |   |   |   |   |   |   |   |   |   |   |   |   |   |   |   |   |
|   | # |   | # | # | # | # | # | # | # | # | # | # | # | # | # | # | # | # | # |
|   |   |   |   |   |   |   |   |   |   |   |   |   |   |   |   |   |   |   |   |
